+--+--+--+--+--+--+--+--+--+--+
|        |        |        |  |
+  +  +  +--+--+  +  +--+--+  +
|  |  |        |  |     |     |
+  +  +--+  +  +  +--+  +  +--+
|           |  |        |  |  |
+  +--+--+  +  +--+  +--+  +  +
|  |        |     |  |        |
+  +--+  +--+  +--+  +--+--+  +
|     |        |     |        |
+  +--+  +  +  +--+  +  +--+  +
|  |     |  |        |  |     |
+  +--+--+  +  +--+--+  +--+--+
|                 g           |
+--+--+--+--+--+--+--+--+--+--+
